1111111111111
100P000000001
1000E00000001
10000000C0001
10P0010010001
1000010010001
1000010010001
1111111111111
