1111111111111
100P00000C001
1000E00000001
0000000000C01
10C0010010001
1000010010001
10C0010010001
1111111111111
