1111111111111
1E0C0P00000011
1111111111111
