1111111111111
100P000000001
1000E00000001
1000000000001
1000010010001
1000010010001
1000010010001
1111111111111
