1111111111111
100P000000001
1000000000001
10000000C0001
1000010010001
1000010010001
1000010010001
1111111111111
